R 600 600
NO ./srcs/imgs/mossy.xpm
SO ./srcs/imgs/greystone.xpm
WE ./srcs/imgs/colorstone.xpm
EA ./srcs/imgs/purplestone.xpm
S ./srcs/imgs/pilar.xpm
F 150,100,100
C 100,100,180

111111111111111111
100000002220000001
100000000000000001
100000000N00000001
100000000000000001
100000000000000001
100000000000000001
111111111111111111